3,2,1,lili712 (7年級韭菜),[問卦] 驚！韓國猛男秀台灣場男生可以去？,Fri Sep  8 22:15:48 2023
11,5,6,ppp123 (3p哥),[問卦] 為什麼不就近跟中國買蛋？,Sat Sep  9 07:37:35 2023
11,6,5,zephyr105 (跳跳),[新聞] 林襄再挑戰新妝髮！「眼窩發青」,Sat Sep  9 04:44:00 2023
4,1,3,GonVolcano (火山君),[問卦] 大谷該去水手隊了吧,Fri Sep  8 22:39:55 2023
3,0,3,brucetu (sec),[問卦] 小時候用過學校飲水機的進來,Fri Sep  8 21:52:12 2023
22,18,4,chun0303 (chun),[新聞] 美麗島民調：侯友宜超車柯文哲差距拉大 ,Sat Sep  9 00:00:21 2023
3,9,-6,nobody0303 (),[問卦] 沒人發現台灣是個對人相當冷漠的國家嗎！,Sat Sep  9 01:20:45 2023
3,0,3,silencepap (p  p),Re,Fri Sep  8 23:36:30 2023
5,0,5,asd245438 (不要問，一切都是幻影~),[新聞] 西村彗星將現蹤 錯過再等300年,Fri Sep  8 22:47:20 2023
3,0,3,fenway18 (軟弱 是沒有辦法贏回國家),[新聞] 俄國非法徵兵徵到古巴去! 17人被捕 古巴 ,Fri Sep  8 22:44:27 2023
21,4,17,q1qaz2 (),[問卦] 台北腹地比高雄屏東小7倍確塞了700萬人？,Fri Sep  8 23:00:53 2023
13,1,12,kinve1014 (黑松可樂),[問卦] 趁亂po個伊織萌奶圖?,Fri Sep  8 22:51:56 2023
4,0,4,keyj (裝羊),Re,Fri Sep  8 22:24:07 2023
8,2,6,ffdqfe (苦惱),[問卦] 新switch會不會吹太大？,Sat Sep  9 05:59:15 2023
5,2,3,glenex (薄薄),[問卦] 籃球世界盃是不是有點冷啊,Sat Sep  9 01:52:12 2023
1,0,1,toofat (南勢角野郎哥),Re,Fri Sep  8 22:40:55 2023
2,2,0,trylin (電鈴怪客),[問卦] 薪水調的比基本工資少怎麼調適心情？,Fri Sep  8 23:52:44 2023
2,0,2,yamahabbs (老ㄟ),[問卦] 住菜寮的人房子都是農舍嗎,Sat Sep  9 08:38:08 2023
10,1,9,Galette (嘉莉朵),[問卦] 開彩票行賺嗎？〓〓,Fri Sep  8 21:25:43 2023
7,0,7,lycs0908 (岳岳),[問卦] 變頻冷氣一整天都不關也很省電嗎?,Fri Sep  8 22:43:46 2023
48,9,39,zoeapezoo (),[新聞] 審計查核 桃園音樂劇場 全年收入僅13萬 ,Fri Sep  8 22:12:26 2023
0,0,0,Kimmy (Kimi),[問卦] 鹵鵝頭真的那麼好吃嗎？,Sat Sep  9 09:00:41 2023
2,0,2,jp6vu04boy (客家肥肥),[問卦] 歐巴桑做壞事都會有什麼動作？,Sat Sep  9 08:50:41 2023
4,2,2,nobody0303 (),[問卦] 沒人發現台灣很多事都是直接被拍板定案！,Sat Sep  9 01:59:47 2023
3,1,2,todao (心裡有數),[問卦] 你把我灌醉 你讓我流淚,Sat Sep  9 01:58:13 2023
7,2,5,NARUTO (鳴人),Re,Fri Sep  8 23:48:29 2023
5,0,5,abcd5566 (我是綠粉),[問卦] 時薪漲到183便利商店跟麥當勞會漲多少,Sat Sep  9 00:08:09 2023
0,1,-1,Goodinfo (Goodinfo),Re,Fri Sep  8 21:37:46 2023
6,0,6,akuan413 (...),[問卦] 台灣的颱風 地震 無良建商 那個恐怖？,Fri Sep  8 22:28:29 2023
5,0,5,godofsex (性愛戰神),[新聞] 無印良品失竊3100件商品才發現 夫妻雙賊,Sat Sep  9 08:49:59 2023
18,8,10,joshchen (拍我的想法),[新聞] 漏報建商老公資產 施淑婷：不清楚配偶要,Fri Sep  8 23:58:56 2023
3,0,3,edieedie (辭小鬼),Re,Fri Sep  8 21:12:40 2023
43,26,17,rick102233 (),[問卦] 中天：華為賣這麼好，iPhone15不用賣了,Sat Sep  9 01:23:00 2023
5,5,0,iphone55566 (哀鳳五),[新聞] 2024大選／侯友宜拋徵富人稅政見 調漲基,Sat Sep  9 08:31:45 2023
4,3,1,hittler (西斯特),Re,Sat Sep  9 05:46:39 2023
9,4,5,zhuilou ( ),[問卦]新加坡健達繽紛樂才賣25台幣 台灣盤子?,Fri Sep  8 21:18:52 2023
0,0,0,freedomnavy (心情書生),[問卦] 各位肥宅，你懷念沒有line 的日子嗎？,Fri Sep  8 22:49:33 2023
1,1,0,Imotucc (建築師巴布),[問卦] 淦台灣診麼這麼貴,Sat Sep  9 01:02:18 2023
1,2,-1,pchunters (齁齁齁),[新聞] 她嘆剛上大學「交不到朋友怎麼辦」？網,Fri Sep  8 21:36:20 2023
26,1,25,KINMENKING (亂世狂刀),[新聞] 美國商務部：正在取得華為新機陸製7奈米,Fri Sep  8 21:03:10 2023
2,0,2,assassinASHE (幹古專用帳號),[問卦] 弄壞別人安全帽要賠多少??,Sat Sep  9 05:59:09 2023
6,5,1,zhuilou ( ),[問卦] 台灣廢物租屋仔怎麼這麼多?,Sat Sep  9 00:12:09 2023
8,0,8,shiaubai (曹吉邁),[新聞] 朱邀柯喝咖啡被邊緣化？郭台銘：我只跟,Sat Sep  9 00:00:16 2023
11,1,10,BlueBird5566 (賴粉意見領袖),Re,Fri Sep  8 23:58:07 2023
1,0,1,yoshilin (多點知士少點騎士),Re,Fri Sep  8 21:43:47 2023
83,40,43,nightwing (夏日浮雲),[新聞] 賴清德萬里老家事件 立委賴品妤批侯友宜,Sat Sep  9 03:10:55 2023
5,1,4,HNCB2880 (淺淺的微笑就像烏梅子醬),[問卦] 博人傳是不是要燃起來了？,Sat Sep  9 06:18:15 2023
30,10,20,lwt501cx (爆裂魔法Explosion！！),[公告] 八卦板板規修訂案於GossipPicket討論,Tue Sep  5 18:30:30 2023
0,1,-1,k99t (聖誕小雞),[問卦] 有沒有偏門賺錢法 一般人從那賺的八卦？,Fri Sep  8 21:33:43 2023
1,2,-1,sixkeeper (烏毛洗螻蟻),Re,Fri Sep  8 21:56:31 2023
124,0,124,huabandd (我是阿肥巴你頭),Re,Fri Sep  8 23:58:44 2023
0,0,0,lelena (太陽神-RA),"[問卦] 建商蓋這麼多2房,這樣生兩個小孩怎麼辦?",Sat Sep  9 08:58:36 2023
6,1,5,dansy (Eye Taiwan),Re,Sat Sep  9 01:12:12 2023
2,0,2,nothisman (在人海中迷失),[新聞] 台中頭汴坑山城藝術季開幕 蝙蝠洞換藍染,Fri Sep  8 22:08:52 2023
0,0,0,wahaha99 (此方不可長),Re,Fri Sep  8 21:02:53 2023
16,2,14,taot917 (每天一點新鮮),[問卦] 大直下陷民宅，可能吊起來嗎？,Sat Sep  9 02:00:16 2023
6,1,5,assassinASHE (幹古專用帳號),[問卦] 棒球啦啦隊的隊服送洗 過程會有人偷聞嗎?,Sat Sep  9 07:47:33 2023
1,0,1,b19880115 (),[新聞] 建案施工出錯釀公寓嚴重坍塌 王世堅怒告,Fri Sep  8 22:36:42 2023
2,0,2,ppp123 (3p哥),[問卦] 可否公開 超思的EPS嗎？,Sat Sep  9 07:54:55 2023
1,0,1,Qorqios (丟臉比丟書還快==),[問卦] 今年有最頂的館長月餅嗎？,Sat Sep  9 00:40:44 2023
13,21,-8,asppsa (橘子綠了),[新聞] 賴清德將成立直播音樂頻道　「療癒賴桑,Sat Sep  9 08:29:20 2023
44,10,34,karta328 (我不知),[新聞] 大直民宅塌陷！辣妹老闆娘現烤麵包送暖　,Sat Sep  9 07:40:51 2023
3,1,2,applegoodeat (蘋果好吃),Re,Fri Sep  8 22:17:38 2023
17,0,17,heero0333 (hero),[問卦] 住大直的好處是什麼 掛?????????????????,Sat Sep  9 08:27:16 2023
2,0,2,smileboy2016 (Sand Tree Pad),[問卦] 時薪183哪族群最爽？,Fri Sep  8 23:59:22 2023
7,2,5,fatslave (),[問卦] 我懷疑我活在楚門的世界,Fri Sep  8 22:12:48 2023
2,2,0,goldenhill (我的人權時代),[新聞] 安平碼頭動漫風「航海王」千陽號登陸台南,Fri Sep  8 21:14:37 2023
3,2,1,redDest (紅油),[問卦] 甲甲救台灣？,Sat Sep  9 01:19:14 2023
21,3,18,cj4385283 (Linhi),[問卦] 中國有啥理由把台灣拿下來,Sat Sep  9 08:27:28 2023
3,9,-6,ai770116 (東方的神秘力量),[問卦] 沒人發現台灣是全世界最痛苦的國家嗎？,Fri Sep  8 22:17:34 2023
4,2,2,shampoopoo (毛寶洗髮精),[問卦] 男生朋友不准我用交友軟體,Sat Sep  9 00:04:10 2023
2,0,2,lightwish (穹願),[新聞] 內蒙古哮喘病患擠爆醫院 官方解釋引質疑,Fri Sep  8 23:25:41 2023
5,2,3,Xaymaca (夏),Re,Sat Sep  9 07:37:35 2023
3,2,1,ALEX492 (ALEX),[問卦] 是我爸媽沒錢還是不想給我太多？,Sat Sep  9 01:33:06 2023
11,0,11,moneybuy (),[問卦] tiktok怎麼不挑戰考試第一名= =,Sat Sep  9 01:53:24 2023
4,0,4,gaiaesque (一起來聽techno八 o'_'o),[問卦] 處男選...? o'_'o,Fri Sep  8 22:07:08 2023
2,1,1,yule1224 (政治是高明的騙術),[問卦] 王力宏變澳洲白人？,Fri Sep  8 22:36:57 2023
3,0,3,devidevi (凱特),Re,Sat Sep  9 08:47:20 2023
4,0,4,incident (貴賓狗可愛:)),[問卦] 有沒有酸酸的空氣的八卦？,Sat Sep  9 03:03:29 2023
0,0,0,sweet79731 (),Re,Fri Sep  8 21:16:32 2023
3,2,1,SaberMyWifi (賽巴),Re,Fri Sep  8 21:39:01 2023
6,0,6,lpbrother (LP哥(LP = Love & Peace)),[新聞] 玉澤演來台倒數 密謀街頭慢跑探險,Sat Sep  9 08:07:10 2023
3,1,2,lockinboy (嘿唷嘿唷),[問卦] 去泰國要怎樣才不會變豬仔,Fri Sep  8 22:08:53 2023
3,0,3,Ommmmmm5566 (有人責備我們不夠深入),[問卦] 真的有人從來沒跟女友吵架過的嗎,Fri Sep  8 22:22:38 2023
1,1,0,Rrrxddd (有噴 nlnlOeO RR ),[問卦] 最強悍的第三者 永遠都不是別人,Sat Sep  9 00:57:49 2023
4,0,4,choobii (我是雞掰郎),[問卦] 受災戶賠一戶新建案如何?,Fri Sep  8 23:20:57 2023
10,1,9,b1b2b3b4 (lemon),[新聞] 梁朝偉自爆看著《色．戒》獎座流口水！拍,Sat Sep  9 01:31:52 2023
4,3,1,holiybo (米羅),[問卦] 調基本工資最倒楣的是不是公務員？,Sat Sep  9 01:10:46 2023
1,3,-2,s088037 (大鼻),[問卦] 50萬創業除了賣蛋還有什麼好創的,Fri Sep  8 22:30:39 2023
36,34,2,BMWi3 (在那叫什麼),[新聞] 柯文哲「不知為何不支持」代孕法案 婦團,Fri Sep  8 23:13:50 2023
3,0,3,z753951zxc (這是ID),Re,Fri Sep  8 23:18:48 2023
7,1,6,damm (S e t h),Re,Fri Sep  8 20:59:23 2023
1,3,-2,fatslave (),Re,Sat Sep  9 08:40:01 2023
4,0,4,chubby31190 (優文專家),[問卦] 大學租屋 跟女朋友住/跟朋友住 有差嗎,Sat Sep  9 01:33:43 2023
10,3,7,abcd5566 (我是綠粉),[問卦] 基本薪資調漲日子會越來越難過嗎,Fri Sep  8 23:00:34 2023
7,4,3,waymayday (不要問),[問卦] 男朋友住五千萬豪宅 是不是可以嫁了,Fri Sep  8 21:07:14 2023
242,1,241,,,
18,2,16,ksxo (aa),[新聞] 板橋疑餵藥案發回續查 家長：初衷為追查,Fri Sep  8 23:43:23 2023
10,1,9,Nodens (大車駕訓班 榮譽教練),[問卦] 老屋抓漏成功機率？,Sat Sep  9 00:29:55 2023
23,0,23,DeepRed0412 (深紅),Re,Fri Sep  8 23:33:13 2023
2,0,2,Townshend (Pete),[問卦] 便利店的尼采老師怎麼紅的?,Fri Sep  8 21:46:21 2023
21,5,16,turndown4wat (wat),[新聞] 「竹北天坑」公務員家中搜到百萬現金,Fri Sep  8 23:41:26 2023
159,30,129,mongi (大體老屍),[問卦] 朱學恒是死豬不怕開水燙代表嗎,Sat Sep  9 03:06:59 2023
4,2,2,KingChang711 (傳統棒球價值最終勝利),[問卦] 在線等！如何抵制台新金控,Sat Sep  9 02:12:47 2023
3,1,2,kimura0701 (一天要喝3千cc的水),[問卦] 幹最近一直下雨是在下怎樣的啦,Fri Sep  8 23:56:38 2023
58,7,51,deitly (一萬光年的愛情),[問卦] 台灣離婚率亞洲第一，生育率世界最差,Sat Sep  9 07:11:13 2023
6,1,5,EVEA (新試劑扶英戰士),[問卦] 我家隔壁在蓋房 我家有機會坍陷嗎????,Sat Sep  9 05:17:12 2023
58,13,45,a000000000 (比古A十郎),Re,Fri Sep  8 21:39:33 2023
5,5,0,manhaspen (男人有筆),[問卦] 錢買不到的東西是什麼？,Fri Sep  8 23:25:13 2023
0,1,-1,Khui1014 (輝),[協尋] 9/1 17：30新店安和路三段中油加油站前,Sat Sep  2 13:24:35 2023
0,0,0,love100 (粉紅籃球鞋),Re,Sat Sep  9 08:58:40 2023
9,1,8,f230072828 (汝被閹之),[問卦] 漢人當年到台灣當移工後是怎麼反客為主?,Fri Sep  8 23:21:36 2023
0,0,0,chunchie (阿奇),[新聞] 超美秘書下班前「腿軟倒地」！同事以為,Sat Sep  9 08:59:21 2023
6,0,6,NUMB43 (晚了~該睡了),[問卦] 現在存錢是不是最笨的,Sat Sep  9 02:01:46 2023
6,0,6,leon131417 (),[問卦] 微波地瓜是不是最方便的澱粉,Sat Sep  9 01:40:18 2023
5,1,4,Ayanami5566 (綾波五六),[問卦] 你現在的桌布是什麼？敢PO出來嗎？,Fri Sep  8 23:08:30 2023
8,5,3,qq326 (奈何還是要分離...),[問卦] 去KTV喝酒真的讓人很困擾!,Fri Sep  8 22:02:43 2023
7,2,5,kinjk01 (小白),[問卦] 火影忍者後面是在亂畫？,Sat Sep  9 03:32:21 2023
16,3,13,anti87 (00),[問卦] 蘋果股價兩天重挫6.5%,Fri Sep  8 21:19:04 2023
0,0,0,pchion2002 (阿我就怕被罵阿),Re,Fri Sep  8 23:22:07 2023
27,4,23,ALEX492 (ALEX),[問卦] UNIQLO材質是不是很爛？,Fri Sep  8 22:50:09 2023
6,0,6,sea130281 (胃哥),[問卦] 如果你是基泰老闆?,Sat Sep  9 03:20:52 2023
5,0,5,Comebuy (三分鐘熱度),[新聞] 荷蘭明訂青少年勞工權 最早13歲就能打工,Fri Sep  8 21:55:08 2023
232,33,199,Augustsixth (　),[爆卦] 民眾黨新竹市議員宋品瑩FB,Sat Sep  9 07:36:47 2023
10,0,10,ivorysoap (ivorysoap),[問卦] 有一說一這八年來各位調薪有比照基本薪嗎,Sat Sep  9 00:49:20 2023
16,4,12,longwayway (路人甲),[新聞] 金正恩訪俄「極樂列車」曝！美女隨侍20hr,Sat Sep  9 00:00:55 2023
2,2,0,WeiU (台大IU),Re,Fri Sep  8 23:30:05 2023
5,0,5,Superxixai (Lux sit),[問卦] 新竹有什麼景點跟美食嗎？,Sat Sep  9 08:17:56 2023
1,0,1,iversonya (iverson#3),[問卦] 東元醫院的梗，理工猴子,Sat Sep  9 07:33:14 2023
5,2,3,F16V (Handler One),[新聞] 斯洛伐克接收首架F-16 Block 70戰機,Sat Sep  9 06:37:55 2023
3,1,2,g7a7n7 (優文製造機),[問卦] 看到男人中的天菜會有想肛的衝動嗎,Sat Sep  9 04:25:10 2023
8,2,6,rz2x (弗朗西爾我婆),[爆卦] SpaceX發射載人火箭上太空(搞錯惹,Sat Sep  9 00:28:58 2023
1,0,1,kikiki37 (441),[問卦] 危!美國會不會輸德國阿?,Fri Sep  8 22:08:17 2023
1,0,1,choobii (我是雞掰郎),Re,Fri Sep  8 22:03:49 2023
11,6,5,pentoxide (Penta),Re,Fri Sep  8 21:07:44 2023
36,12,24,googolplex (googolplex),[新聞] 基本工資連8漲！只對「這群人」有好處,Sat Sep  9 02:47:28 2023
5,34,-29,dragonmester (),[問卦] 蔡桃貴超暖笑容曝光 融化一票粉絲,Sat Sep  9 00:06:22 2023
4,2,2,daisy100 (hey),[問卦] 失明了會自殺嗎,Fri Sep  8 23:20:20 2023
5,2,3,trylin (電鈴怪客),[問卦] 自稱可愛的女生是不是都超肥？,Fri Sep  8 23:44:21 2023
0,0,0,CavendishJr (五劑究極梅西),Re,Sat Sep  9 08:59:45 2023
3,1,2,laidon (賴董),Re,Sat Sep  9 04:15:03 2023
11,3,8,fenway18 (軟弱 是沒有辦法贏回國家),[問卦] 為什麼日韓基本工資能夠這麼高?,Fri Sep  8 22:24:37 2023
9,4,5,ilw4e (可以吃嗎？),Re,Sat Sep  9 01:51:56 2023
11,26,-15,ckshchen (尖酸苛博文),[新聞] 侯友宜拋長者健保免費 陳時中提醒「別被,Fri Sep  8 22:39:04 2023
5,1,4,AZTEC (直球對決),[問卦] 有沒有基泰弄垮房子一樓住戶的八卦?,Fri Sep  8 21:50:07 2023
3,3,0,hushiang (我練功發自真心),Re,Sat Sep  9 00:46:41 2023
7,1,6,dragonmester (),[問卦] 每年調薪1000 30年後就3萬了耶,Sat Sep  9 00:37:15 2023
7,3,4,ALEX492 (ALEX),[問卦] 台灣知名度什麼時後起來的？,Sat Sep  9 01:06:02 2023
2,1,1,A98454 (小羅賓),[問卦] 大家買股票484都賺翻了,Sat Sep  9 07:55:16 2023
5,2,3,missucrystal (妳還好嗎),[問卦] 社會是不是越來越不給內向的人活路,Sat Sep  9 07:09:44 2023
28,1,27,archer389 (黑騎士389),[問卦] 草帽團的收入哪裡來的啊,Fri Sep  8 23:59:08 2023
5,2,3,tsengcc (),[新聞] 跨228連假...超思2天復業有貓膩？國稅局,Fri Sep  8 23:12:13 2023
13,2,11,fox5451 (fox5451),[問卦] 公司資本額不就是用在出事的時候嗎,Sat Sep  9 04:05:18 2023
2,3,-1,segawar (超愛5566^^),[問卦] 如果丟丟妹 和 天后闆妹 選一個,Sat Sep  9 00:35:43 2023
6,0,6,InoueNagi (),[問卦] 當真あみ(16)南沙良(21)哪個頂?,Fri Sep  8 23:10:08 2023
20,3,17,Superxixai (Lux sit),[問卦] 在緯創輸六位數了怎麼辦,Sat Sep  9 07:45:36 2023
0,0,0,xzcb2008 (可愛老娘變態貓貓=.=),Re,Sat Sep  9 08:57:33 2023
0,0,0,deathfire (天龍巴布),[問卦] 瘦子E.SO的粉絲會喜歡伊索寓言嗎,Fri Sep  8 21:31:49 2023
3,0,3,todao (心裡有數),Re,Sat Sep  9 02:21:57 2023
3,1,2,InoueNagi (),[問卦] 轉生為小早川秀秋在關原會打哪一邊?,Fri Sep  8 22:38:59 2023
19,38,-19,village0817 (是我啦),[新聞] 蔡總統：基本工資連8年調升 政府當勞工朋,Fri Sep  8 21:11:40 2023
4,7,-3,g7a7n7 (優文製造機),[問卦] 憑什麼養寵物要領養代替購買,Sat Sep  9 00:21:54 2023
2,3,-1,abby99 (頌樂老婆),[問卦] 您看過最廢的廢文是哪篇,Sat Sep  9 02:04:15 2023
4,0,4,manhaspen (男人有筆),[問卦] 時間的起點是什麼？,Fri Sep  8 23:35:18 2023
0,4,-4,david0426 (軒軒寶貝),[問卦] 我朋友聽錄音帶聽到穿越(在線等,Fri Sep  8 21:42:19 2023
7,3,4,Beziehung (Beziehung),[問卦] 周杰倫演唱會受傷？,Fri Sep  8 23:39:11 2023
5,0,5,valkyrie (1234),[問卦] 新十二生肖和里見八犬傳哪個好看？,Fri Sep  8 22:57:23 2023
5,0,5,spark13579 (佑風),[問卦] 請問台南現在雨很大嗎？,Sat Sep  9 00:36:42 2023
10,3,7,wegoWU (辜菀允鐵粉♥ ),[問卦] 女老闆手下黑、淫、貪都有?她知道嗎?,Fri Sep  8 22:40:12 2023
3,1,2,G2S (呂雅筑),[問卦] 台南人咖啡會加糖嗎?,Sat Sep  9 01:39:07 2023
29,4,25,chekove (tit for tat),[新聞] 超思負責人為何不露面？他揭真實身分：出,Fri Sep  8 22:47:52 2023
2,0,2,jongam (全站最中肯),[問卦] 是不是該請國安人員保護秦語喬？,Fri Sep  8 23:24:46 2023
0,0,0,GreedyBian (貪扁),[問卦] 為什麼日本的「國產」看起來好吃 我們的,Sat Sep  9 08:54:40 2023
12,8,4,daven0987 (鴨子),"[問卦] 習近平太囂張,已經沒法阻止92共識了嗎?",Sat Sep  9 05:27:16 2023
4,0,4,MeiHS (簽名檔詳見 其他版晃到，),[問卦] 蘇軍的擲彈兵，很好用嗎？,Sat Sep  9 06:53:30 2023
1,0,1,sxy67230 (charlesgg),Re,Fri Sep  8 21:55:53 2023
5,0,5,rogerok (司機我也要上車),Re,Fri Sep  8 22:27:21 2023
2,1,1,w510048 (黨的恩情比山高),[問卦] 留學七年花爸爸兩千萬算不孝嗎?,Fri Sep  8 21:17:46 2023
53,12,41,Manzini (Manzini),[問卦] 2500萬老房換 7300萬豪宅 不香？,Fri Sep  8 20:56:37 2023
10,5,5,ai770116 (東方的神秘力量),[問卦] 為什麼台灣人移民美國就變正常人？,Fri Sep  8 23:02:20 2023
2,1,1,donaldmusk (DonaldMusk),[問卦] 嫌交友軟體太多約炮仔是不是搞錯什麼,Fri Sep  8 22:46:14 2023
0,0,0,DCHC (純愛基本教義派♥),Re,Sat Sep  9 00:55:52 2023
1,0,1,jfw616 (jj),Re,Fri Sep  8 22:54:24 2023
8,5,3,applegoodeat (蘋果好吃),Re,Fri Sep  8 21:48:55 2023
0,0,0,RINPE (RIN),[問卦] 貓奴是不是變多了？,Sat Sep  9 09:00:50 2023
1,0,1,reppoc (稍會),[問卦] 建商賠償住戶1F要算1F還是B1?,Fri Sep  8 22:17:08 2023
2,1,1,damingli90 (永遠愛冬冬),[問卦] 現在男生的瀏海怎麼都那麼韓阿,Fri Sep  8 21:45:55 2023
14,2,12,utomaya (烏托馬雅),[問卦] 哪一首歌曲的YT點閱破10億次讓你最驚訝？,Fri Sep  8 23:48:58 2023
5,0,5,ffdqfe (苦惱),[問卦] 是不是應該復興蹲式馬桶？,Sat Sep  9 00:42:33 2023
3,2,1,tanyatw (bruh7777),[問卦] 30以前轉職都來得及嗎？,Sat Sep  9 03:20:42 2023
6,5,1,pttbeigowow (想狗窩啊),[問卦] 調漲基本薪資根本均貧卡啊？,Sat Sep  9 00:04:52 2023
0,0,0,songgood (ilovegoodgame),Re,Sat Sep  9 07:36:13 2023
2,1,1,hittler (西斯特),[問卦] 長野縣人到高雄美濃旅遊會怎麼想?,Sat Sep  9 08:03:33 2023
5,0,5,chubby31190 (優文專家),Re,Fri Sep  8 22:03:49 2023
2,6,-4,zombiechen (zom),[問卦] 是不是真的4%的人毫無良知,Sat Sep  9 00:08:28 2023
5,2,3,mofass (廢文產生器),[問卦] 旅行的意義這首歌超綠茶的吧？,Fri Sep  8 22:14:31 2023
6,0,6,j0588 (),Re,Sat Sep  9 08:10:03 2023
2,1,1,cmelo1515 (瓜農),[問卦] 急！！這時間球針哪裡買？,Sat Sep  9 08:31:01 2023
4,0,4,for5566 (Yo),[問卦] 為什麼當初會選台北當首都？,Fri Sep  8 22:39:16 2023
86,90,-4,NARUTO (鳴人),[新聞]賴品妤訴礦工寮悲歌 談賴清德違建爭議批侯,Fri Sep  8 22:01:41 2023
1,0,1,Qorqios (丟臉比丟書還快==),[問卦] 好日子遠行‧往西 ？,Sat Sep  9 08:19:19 2023
6,1,5,saisai9230 (小為),[新聞] 代言隆乳「奶奶快回家」遭嘲氣炸！G乳辣模怒告…二審逆轉勝獲賠,Fri Sep  8 21:17:33 2023
4,6,-2,eeth (韓國綜藝社),[新聞] 法國國會疏遠中共 臺灣起關鍵作用,Fri Sep  8 21:27:52 2023
14,1,13,"yang560831 (""壞人""喬尼)",[問卦] 飛機杯臭死了怎麼辦？,Sat Sep  9 00:05:26 2023
3,1,2,nckuff (nckuff),[問卦] 超市看到冷藏雞蛋10入賣278好吃嗎？,Fri Sep  8 22:55:41 2023
5,1,4,joanzkow (星浪),[爆卦] 男籃世界盃四強美國夢幻隊輸德國！！,Fri Sep  8 22:34:36 2023
34,14,20,gaiaesque (一起來聽techno八 o'_'o),[問卦] 143 這身材484頂到肺 o'_'o,Sat Sep  9 06:54:02 2023
6,1,5,kinki5566 (近畿小子5566),[問卦] 用一堆千斤頂跟吊車把房子拉回去不就好了？,Fri Sep  8 21:49:57 2023
4,0,4,s820912gmail (愛黨替代役覺青),[問卦] 將軍滷味只有1.8星是怎麼辦到的？,Fri Sep  8 21:44:58 2023
3,6,-3,valley (專打蟑螂),[問卦] 一大早好多露腰小姊姊？,Sat Sep  9 07:03:39 2023
17,7,10,f230072828 (汝被閹之),[新聞] 台灣「低薪地獄」新住民超有感 只住得起,Fri Sep  8 21:03:18 2023
8,3,5,answermangtr (牧羊少年),[問卦] 有人用銀當電線嗎,Sat Sep  9 01:51:49 2023
0,0,0,IngGG (石更 奚隹 奚隹),Re,Sat Sep  9 08:56:22 2023
12,1,11,createlight (創輝),[新聞] 中國人口危機 習近平下令鼓勵軍隊生三孩,Fri Sep  8 21:39:10 2023
5,0,5,OPPAISuki (OPPAISuki),[問卦] Lisa去跳 瘋馬秀 會上空嗎? 阿嘶,Fri Sep  8 21:51:31 2023
6,2,4,usnavyseal (usmarine2008),[問卦] 英國單車騎中間保安全 台灣不靠邊變廢鐵,Fri Sep  8 23:39:29 2023
8,1,7,BroDians (網圍包),[問卦] 150元以上的便利商店義大利麵賣給誰？,Sat Sep  9 00:57:07 2023
0,0,0,toolan (土狼),Re,Sat Sep  9 04:01:31 2023
0,0,0,jerry1019 (古密斯),Re,Sat Sep  9 01:22:11 2023
3,1,2,Galette (嘉莉朵),[問卦] 串流有什麼不錯的電影,Fri Sep  8 22:07:08 2023
9,4,5,ppp123 (3p哥),[問卦] 外勞二代是不是長大了？,Fri Sep  8 21:30:17 2023
8,1,7,qq326 (奈何還是要分離...),[新聞] 最強高中生」也來！ 輔大招生100%金熬 ,Fri Sep  8 21:36:53 2023
2,0,2,sanshin (中田祥),[問卦] 現在是不是大許願時代？,Fri Sep  8 22:03:08 2023
18,8,10,Workforme (′‧ω‧‵),[新聞] 薪水小偷？同事「趁主管休假」手機滑一,Sat Sep  9 06:57:45 2023
1,1,0,Yirgacheffe (守住善良),[新聞] 刺激政策無效？中國百強房企8月銷售跌四成,Fri Sep  8 22:59:55 2023
113,31,82,NasaZheng (Nasa_Zheng),[問卦] 求助！家中疑似出現三葉蟲,Fri Sep  8 21:26:01 2023
18,14,4,sukiyasuica (suica),[新聞] 大直民宅下陷！王鴻薇遭爆沒幫住戶說話　,Sat Sep  9 06:43:28 2023
23,20,3,CREA (人間不信),[新聞] 連續8年調升基本工資 蔡英文：共享經濟成長果實,Fri Sep  8 21:29:29 2023
2,1,1,IokUdiefirst (武漢肺炎),[問卦] 隔壁開始施工房子就傾斜 該怎麼辦?,Sat Sep  9 05:38:06 2023
25,2,23,lienchi (...),[問卦] 法律上的一罪一罰是不是幹話,Sat Sep  9 01:04:32 2023
1,0,1,inoce (),[問卦] 所以黃仁勳大賣輝達在哪？？,Sat Sep  9 08:34:40 2023
5,6,-1,aabbcc520 (U質文),[問卦] 31處男問如何戒掉買股票賠錢但還是想買,Sat Sep  9 08:27:26 2023
20,4,16,xzcb2008 (可愛老娘變態貓貓=.=),[問卦] =.= 是什麼原因造成台女比台男更享樂主,Fri Sep  8 22:28:15 2023
5,1,4,poeta (鍵盤詩人),[問卦] 請問要分享網路給樓下 路由器要顛倒嗎,Sat Sep  9 01:03:17 2023
4,1,3,vy8824 (巴塞隆納- 紐塞),[問卦] 買洗浴品送人484怪怪的,Sat Sep  9 00:44:26 2023
2,4,-2,EVEA (新試劑扶英戰士),[問卦] 2023年11月14又是世界末日怎麼辦 ,Sat Sep  9 05:48:17 2023
5,0,5,lpbrother (LP哥(LP = Love & Peace)),[問卦] 住家隔壁就是建案有多痛苦？,Sat Sep  9 08:34:17 2023
0,0,0,ALEX492 (ALEX),[問卦] 買票判定是不是有問題？,Sat Sep  9 02:14:32 2023
103,18,85,jal0309 (jal0309),[新聞] 快訊／發慰問金夾帶「合建意向書」　基,Sat Sep  9 00:04:23 2023
5,0,5,sinkerwang40 (阿任),[問卦] 明天會更好 互毆 手牽手誰贏？,Sat Sep  9 01:18:03 2023
8,4,4,Ayanami5566 (綾波五六),[問卦] 急！老婆要我等她16年後再見面...,Fri Sep  8 22:39:32 2023
2,0,2,meblessme (人身攻擊是爛人),Re,Sat Sep  9 02:08:12 2023
18,4,14,smileboy2016 (Sand Tree Pad),[問卦] 慟！漢寶杯麵味道回不去了？,Fri Sep  8 23:18:49 2023
7,6,1,palindromes (),[新聞] 前男友太大每次都壞掉！她喊「GG小也很,Fri Sep  8 23:27:59 2023
2,0,2,sdbb (MorsCertaVitalIncerta),Re,Sat Sep  9 02:32:11 2023
2,0,2,kalababygi (海勒姆),[問卦] 台灣人是不是越來越虛偽了？,Fri Sep  8 21:20:52 2023
5,19,-14,qazsedcft (多半時候),[新聞] 平權教育失敗？校園歧視言論背後，「政,Sat Sep  9 05:10:32 2023
0,0,0,Max0406 (LeGOATKingJames),[問卦] 為什麼要給小費,Sat Sep  9 08:52:43 2023
10,1,9,hn9480412 (ilinker),[新聞] 美探險家受困土耳其第3深洞穴！逾150人競,Fri Sep  8 21:43:02 2023
6,0,6,wugucc029 (五股CC),[問卦] 抽煙真的可以抽到吐嗎,Fri Sep  8 23:27:58 2023
11,5,6,EVEA (新試劑扶英戰士),[新聞] 末日預言已現3預兆？死海有活魚 信徒驚,Sat Sep  9 06:01:47 2023
33,2,31,jiouje (JioUje),[新聞] 互相取暖！蔡麗清祝「夢到擋人財路」的,Sat Sep  9 07:31:29 2023
0,1,-1,chubby31190 (優文專家),Re,Sat Sep  9 04:52:28 2023
17,3,14,LIN9 (LIN9),[新聞] 天坑吞特斯拉！竹縣工務處長「排水孔藏千,Sat Sep  9 06:49:48 2023
7,2,5,jazy6804 (豪大帥哥),[問卦] 新房附車位不好嗎？,Sat Sep  9 07:10:47 2023
2,0,2,Dukkha (Anagami),Re,Fri Sep  8 22:15:56 2023
8,1,7,tony900735 (安西街教練),[問卦] 101這也太多阿公阿嬤在夜排Swatch聯名,Fri Sep  8 21:26:37 2023
7,3,4,dirtygg (O口O),[問卦] 美國買一顆7元雞蛋會太奢侈嗎？,Sat Sep  9 00:38:54 2023
5,0,5,rainjuly (拜託你了),[問卦] 為什麼Faker可以不在乎錢啊,Fri Sep  8 21:35:50 2023
3,0,3,scissorman (剪刀俠),[問卦] 有沒有芳根京子不如新木優子的卦,Fri Sep  8 21:51:00 2023
6,1,5,LMHK (No one sleep in Tokyo),[問卦] 頭文字D的歌才是本體吧？,Fri Sep  8 23:41:38 2023
23,5,18,flareliu (爆肝新鮮人),[新聞] 主張監管房屋品質 郭台銘喊「不需要錢」,Fri Sep  8 23:17:54 2023
5,0,5,shampoopoo (毛寶洗髮精),[問卦] 我妹跟老男人越來越好算好事嗎,Sat Sep  9 01:22:45 2023
17,2,15,G2S (呂雅筑),[問卦] 女孩子直接用袋子吃泡麵，會讓你軟掉嗎?,Sat Sep  9 02:18:36 2023
9,2,7,coffee112 (我沒拿$就換你網軍死全家),[新聞] 新聞幕後／基泰大直「連續壁」偷工減料？,Fri Sep  8 22:43:25 2023
10,1,9,CHB1980 (阿彬),[問卦] 二戰末期蘇聯紅軍強姦多少婦女?,Fri Sep  8 21:11:21 2023
10,3,7,hmenri (),[問卦] 大腸包小腸什麼時候變成75的？,Sat Sep  9 00:56:09 2023
1,1,0,G2S (呂雅筑),[問卦] 為何台南糖水這麼多?,Sat Sep  9 02:45:17 2023
2,0,2,ptt987654321 (大谷躺平),Re,Fri Sep  8 22:36:54 2023
4,0,4,PrettyOdd (),Re,Fri Sep  8 21:20:43 2023
28,1,27,ROMEL (Bin),[爆卦] 足球國家隊比賽  中華 1:1 菲律賓  和局,Fri Sep  8 21:03:32 2023
13,3,10,iamoldtwo (健力心肺中低體脂我都要),[問卦] 台灣人體能怎麼那麼爛,Fri Sep  8 22:26:55 2023
3,7,-4,aft7795 (Yang),[問卦] 女生：不好意思第一次吃飯就讓你請客～,Fri Sep  8 23:13:20 2023
2,2,0,NoAfraid (小子難纏 不得安寧),Re,Sat Sep  9 00:35:29 2023
71,6,65,oreaoasis (),[問卦] 台北人行道非常適合停汽車吧,Sat Sep  9 01:29:20 2023
4,1,3,asewgek (asew),[問卦] PETA亞洲的宣傳措施是不是太「白」？,Fri Sep  8 21:49:53 2023
33,4,29,b777300 (su35s),[問卦] 大直坍塌建案，應該直接計價賠償才對吧？,Fri Sep  8 23:38:53 2023
7,2,5,qazStarStar (我不是派大星),[問卦] 館長:夏天很長十一月很熱快來買冰淇淋,Fri Sep  8 23:36:01 2023
14,0,14,ahw12000 (醜陋大總統),[問卦] 台灣演藝圈演反派最頂的演員是誰?,Fri Sep  8 23:13:00 2023
8,0,8,pprino (于晏的腦婆),[問卦] 魏德聖會怎麼拍大直沉沒的八卦??,Fri Sep  8 21:18:43 2023
0,0,0,alexbbs (無憂也無慮),Re,Sat Sep  9 08:46:39 2023
14,6,8,KSHLO (Wunderbar),[問卦] 看到前任過得更好如何調適,Sat Sep  9 02:56:38 2023
2,1,1,medama ( ),[問卦] 喜歡爬山勝於連線對戰 是不是老了,Sat Sep  9 07:24:13 2023
6,0,6,inmee (J),[問卦] 每天上班怎麼交到新朋友?,Fri Sep  8 21:45:27 2023
6,1,5,nckuff (nckuff),[問卦] 這樣的宵夜自製鹹派鄉民給幾分？,Sat Sep  9 00:50:54 2023
4,0,4,galaxy13 (zzz~),[新聞] 薪酬低於其他學區 金山教師要罷工,Fri Sep  8 23:18:17 2023
3,0,3,inet (),[問卦] 蓋房子的結構技師薪水很高嗎？,Fri Sep  8 22:45:51 2023
1,2,-1,jazy6804 (豪大帥哥),[問卦] 有沒有劉靖雅在幹嘛的八卦？,Sat Sep  9 07:34:01 2023
3,1,2,NARUTO (鳴人),Re,Fri Sep  8 23:33:30 2023
7,1,6,sunchen0201 (天道酬勤),[新聞] 台北市連現天坑！王世堅點名2局處螺絲掉,Fri Sep  8 21:20:56 2023
8,0,8,Galette (嘉莉朵),Re,Fri Sep  8 21:38:55 2023
14,6,8,yokann (網軍真可怕),[新聞] 影／跟女友談分手遭搶話筒 台中KTV少年憤,Sat Sep  9 07:31:50 2023
7,2,5,FL5566 (小魯妹),[問卦] 跟朋友在一起焦慮是不是會緩和,Sat Sep  9 02:23:43 2023
4,4,0,KSHLO (Wunderbar),[問卦] 有能撼動英文的語言嗎,Sat Sep  9 01:59:27 2023
9,1,8,fengyu118 (煩魚),[問卦] 有沒有人今天也很痛苦的,Sat Sep  9 02:31:06 2023
5,1,4,OAO5566 (OAO),[問卦] 基本工資調升4%，物價會漲幾%?,Fri Sep  8 22:33:57 2023
7,0,7,z25679z25679 (無悔的決定),[問卦] 工程標案利潤5000萬，實拿1500萬不夠賠？,Fri Sep  8 21:57:14 2023
6,0,6,dilson (中肯的話通常不好聽懂嗎),Re,Fri Sep  8 21:14:45 2023
84,12,72,hellspeak (),[問卦] TikTok挑戰又死人了,Fri Sep  8 23:08:04 2023
28,7,21,razan (僅供參考),[新聞] 17年沒漲價 寶礦力11月起每罐漲4 ~5元,Fri Sep  8 23:26:07 2023
0,0,0,s66449 (老實樣),[問卦] 肥宅約女森看愛情電影片有加分嗎？,Fri Sep  8 23:22:59 2023
2,1,1,songgood (ilovegoodgame),[問卦] 侏羅記是在告訴我們,Sat Sep  9 01:29:15 2023
2,1,1,akari7695 (亮),[問卦] 捷運站飲水機有人會用嗎,Fri Sep  8 21:48:20 2023
6,6,0,ai770116 (東方的神秘力量),[問卦] 曾文水庫補滿水八卦在不爽什麼？,Fri Sep  8 22:35:22 2023
11,11,0,abellea85209 (阿比利亞),[新聞] 華為手機這功能「無死角」！退將驚呼：不,Fri Sep  8 21:21:22 2023
2,0,2,Aurora5566 (睡美人),[問卦] 藤浪晉太郎算帥哥嗎？,Sat Sep  9 00:36:07 2023
7,0,7,iamshana (CANINE力集中在一些重要S),[新聞] 躺平就能贏？渡假村辦「懶惰大賽」 選手,Fri Sep  8 21:35:15 2023
12,5,7,CuLiZn5566 (同理心5566),Re,Sat Sep  9 03:05:55 2023
1,0,1,inse (好想退休),[問卦] 烤肉食材有沒有推薦的？,Sat Sep  9 08:49:56 2023
17,0,17,riptheworld (),[問卦] 驚！平行宇宙的我過得怎樣？,Fri Sep  8 22:23:27 2023
1,0,1,yolodick (鍵盤肥宅),[問卦] 整個月薪水下美國的在想什麼？,Fri Sep  8 22:36:19 2023
195,29,166,CNS3056 (奶奶),[新聞] 揭林智堅月租7萬住皇宮!她酸帝王級待遇,Fri Sep  8 22:33:08 2023
0,0,0,HSUGuangHan (蛋堡),Re,Fri Sep  8 22:58:38 2023
33,6,27,"THEHELY (@@"")",[新聞] 「寶礦力水得」撐不住要漲價了　平均貴4,Sat Sep  9 04:26:16 2023
5,0,5,AzTiana (蜂蜜軟糖),[問卦] 與其養公關部是不是不如養網軍,Fri Sep  8 22:57:21 2023
4,1,3,wakaura (wakaura),[問卦] 跟妹子約會該注意些什麼,Fri Sep  8 22:47:45 2023
6,4,2,emperor (派蘿派蘿得第一),[新聞] 婦人騎單車「親吻」高雄輕軌列車 肇事後,Fri Sep  8 21:38:12 2023
7,2,5,ccugoo (小麥),[新聞] 聯發科採用台積電3奈米製程 預計2024年量產,Fri Sep  8 21:26:30 2023
17,12,5,auden (.....),Re,Fri Sep  8 22:11:12 2023
5,2,3,go190214 (天空之島拉普達),[新聞] 靠寫題目對症下藥 兄妹一起考進警專,Sat Sep  9 00:00:17 2023
9,1,8,opengaydoor (開申門),[問卦] 不去google 能說出幾個鄉民女神,Fri Sep  8 22:19:57 2023
1,0,1,xzcb2008 (可愛老娘變態貓貓=.=),Re,Fri Sep  8 23:12:25 2023
102,23,79,MatheFuck (媽英告),[問卦] 2人逢甲隨便吃花了快1000是三小==,Sat Sep  9 00:27:53 2023
4,2,2,engineer1 (爺呼弟),[問卦] 菊花張開像雨傘打開？,Sat Sep  9 00:41:13 2023
0,0,0,GTOyoko5566 (雞頭洋子),[問卦] 前任女友唱歌羞辱我該注意什麼,Sat Sep  9 08:53:43 2023
6,8,-2,ssweet (sweet),[問卦] 大直倒塌工地為什麼沒打樁?????,Fri Sep  8 21:19:48 2023
3,0,3,yuherngshi (我要條碼貓拉><),Re,Sat Sep  9 02:14:31 2023
5,7,-2,alex1987 (基努李維),[新聞] 雞蛋爭議在野黨質疑超思 鄭文燦：沒發現,Fri Sep  8 22:31:04 2023
11,2,9,a6000200 (aa),[問卦] 買春為何不能分期或刷卡？,Fri Sep  8 20:59:56 2023
8,0,8,HTC92 (中国台湾人的驕傲-92共識),[問卦] 明年雞排會賣多少錢？,Fri Sep  8 21:33:33 2023
6,1,5,L1ON (我是獅子~(ﾉﾟ▽ﾟ)ﾉ♪),[問卦] 今天整天新聞爆出台灣到處施工鄰損？,Sat Sep  9 00:58:05 2023
4,0,4,Glamsight (安穩殘憶),[新聞] 前調查局長秘書竟成捷運癡漢！調查官涉「,Sat Sep  9 04:57:35 2023
4,1,3,NUMB43 (晚了~該睡了),[問卦] 劇情A片成本會比較高嗎,Fri Sep  8 22:02:01 2023
3,1,2,abscented (心之所向 素履所往),[問卦] 蛋價要多少才能合乎市場價格,Fri Sep  8 23:12:35 2023
0,1,-1,pauljet (拜登哥不要),Re,Sat Sep  9 00:30:54 2023
1,2,-1,HuangJC (吹笛牧童),Re,Sat Sep  9 01:43:35 2023
2,4,-2,JamesSoong (Patrick Mahomes!!),[問卦] 香港下雨可以放假 台灣呢?,Fri Sep  8 21:47:02 2023
4,0,4,sdbb (MorsCertaVitalIncerta),Re,Sat Sep  9 00:04:22 2023
1,2,-1,slovea (LukeSkyFucker),Re,Fri Sep  8 22:23:09 2023
8,2,6,redDest (紅油),[問卦] 有口內膏 那有肛內膏嗎,Fri Sep  8 23:52:32 2023
7,0,7,aft7795 (Yang),[問卦] 大和拜金女的劇情在現實生活中可能發生嗎,Fri Sep  8 23:29:03 2023
7,0,7,EVEA (新試劑扶英戰士),[問卦] 「住宅三箭」 射去那了?????,Sat Sep  9 06:11:46 2023
3,0,3,shamanlin (佐藤必須死),Re,Fri Sep  8 22:24:54 2023
48,4,44,ohfulow (ohfulow),[問卦] 8年課金10萬多很誇張嗎？,Sat Sep  9 01:34:46 2023
1,2,-1,Rrrxddd (有噴 nlnlOeO RR ),[問卦] 我再問你一次 你會不會彈琴,Sat Sep  9 00:41:10 2023
7,0,7,OAO5566 (OAO),Re,Fri Sep  8 21:13:16 2023
5,1,4,KILLE (啃),[問卦] 中國在科技上有嘴砲過嗎?,Fri Sep  8 22:26:56 2023
61,4,57,leocean9816 (阿光),[新聞] 獨派陳昭姿為「代理孕母」站台柯文哲,Sat Sep  9 00:48:33 2023
11,4,7,poeta (鍵盤詩人),[問卦] 電視購物台 廠商代表氣到離席 是真的嗎,Sat Sep  9 01:13:16 2023
4,1,3,yuzukineko (閃亮三叔公),[問卦] 真人版航海王索隆要怎麼施放三千世界,Fri Sep  8 23:57:55 2023
2,0,2,lockinboy (嘿唷嘿唷),[問卦] 亞洲哪個城市生活最輕鬆,Sat Sep  9 07:34:00 2023
15,4,11,kisswish (但願都好 . . . ),[問卦] 最近一堆新竹市長的新聞...,Fri Sep  8 22:18:21 2023
3,0,3,guanj (gaunj),[問卦] 台灣工程是笑話嗎,Fri Sep  8 21:23:10 2023
11,0,11,Kazmier (代理人),[新聞] 台南登革熱飆破4700例 防成破口4工地勒令,Fri Sep  8 21:44:02 2023
8,1,7,engineer1 (爺呼弟),[問卦] 八卦版是男同俱樂部還是群聊？,Sat Sep  9 01:40:48 2023
3,6,-3,fatslave (),[問卦] 吃麵聞到油蔥有蟑螂味,Sat Sep  9 08:10:06 2023
2,0,2,sky52442009 (),Re,Fri Sep  8 23:12:46 2023
4,1,3,fcugeo (fcugeo1746),[問卦] 為什麼廣東粥吃到後面會膩？,Sat Sep  9 00:39:06 2023
1,0,1,kalababygi (海勒姆),[問卦] 撕破臉指的是不願意一起說謊對吧？,Sat Sep  9 00:09:59 2023
4,1,3,gaiaesque (一起來聽techno八 o'_'o),[問卦] 可愛正妹 o'_'o,Fri Sep  8 21:35:03 2023
10,0,10,wahaha23 (請勿拍打餵食),[新聞] 滂沱大雨澆不熄中華男足決心！1比1踢平,Fri Sep  8 22:31:26 2023
4,0,4,inse (好想退休),Re,Sat Sep  9 08:18:04 2023
80,15,65,Zionward (皇家芭蕾成龍門),[問卦] 如果大樓塌陷發生在高雄，八卦板會怎樣,Sat Sep  9 00:20:42 2023
1,2,-1,teeheehee (軟尾拋拋翔(′・ω・`)),[問卦] 台北以前是湖 那麼有要組建湖人隊嗎？,Sat Sep  9 07:45:54 2023
0,0,0,andrewkuo (),[新聞] 拒傳票要求 特朗普前顧問納瓦羅被判藐視,Fri Sep  8 21:06:39 2023
1,0,1,DeepRed0412 (深紅),Re,Sat Sep  9 08:36:25 2023
14,2,12,rick102233 (),[問卦] 鄰居小孩一天1/3時間在哭鬧怎麼處理？,Fri Sep  8 21:12:25 2023
0,0,0,hphp (天陰陰),Re,Sat Sep  9 08:55:23 2023
1,0,1,zpeople0116 (五五六六不能玩),Re,Fri Sep  8 21:25:17 2023
4,0,4,kinve1014 (黑松可樂),[問卦] 殺死一隻會飛的強哥 如何慶祝？,Sat Sep  9 01:08:26 2023
9,3,6,MoreLight (大文),[問卦] 中國自稱歷史有5000年是從哪時算起的？,Fri Sep  8 23:21:31 2023
1,0,1,MiCy (米賽),Re,Sat Sep  9 02:04:42 2023
1,0,1,dora5191 (累),[問卦] 恆是什麼梗？,Sat Sep  9 08:01:32 2023
4,0,4,MJdavid (膽固醇歐吉桑),[問卦] 有人吃過維力大炒一番-九層塔蛤蜊嗎？,Sat Sep  9 08:50:03 2023
22,5,17,zakijudelo (Zack),[問卦] 近年漲基本工資但不壓物價，在衝三小,Sat Sep  9 07:35:32 2023
3,0,3,IPJ (我要你),[問卦] 有沒有北一女的傳說,Sat Sep  9 08:17:23 2023
7,1,6,kinki5566 (近畿小子5566),[新聞] 誠品書店狂偷拍正妹大腿臀部 噁男辯「我盲拍培養審,Fri Sep  8 21:10:50 2023
86,30,56,jing1219 (Ice cream cake),[新聞] 「handsome」國一孩翻「帥氣的」被打叉,Fri Sep  8 22:09:09 2023
4,3,1,jiern (jiern),[新聞] 「大直成了烏克蘭」王世堅氣炸變身恰,Fri Sep  8 23:05:54 2023
8,2,6,Aurora5566 (睡美人),[問卦] 結果卻拿不到半個獎 不知道該笑不笑,Sat Sep  9 00:44:38 2023
3,1,2,Aurora5566 (睡美人),[問卦] 而我的咖啡 糖不用太多？,Sat Sep  9 00:57:52 2023
10,3,7,EVEA (新試劑扶英戰士),[問卦] 「政府」 什麼時候又當勞工朋友後盾???,Fri Sep  8 21:24:06 2023
93,12,81,Sunny821210 (Vancomycin),[新聞] 住院醫師輕生 友人爆生前遭上級言語羞辱,Fri Sep  8 21:24:03 2023
3,1,2,sihfanchen (sihfanchen),[問卦] 手機登入需要手機認證！如何解？,Fri Sep  8 23:39:39 2023
8,0,8,cchh179 (howie),[問卦] 貨幣通貨膨脹到最後會怎樣？,Sat Sep  9 01:00:48 2023
1,0,1,songgood (ilovegoodgame),[問卦] 別逼我,Sat Sep  9 01:23:13 2023
9,0,9,felixr0123 (felixr0123),[問卦] 吃漢寶蚵仔味細麵了嗎？,Fri Sep  8 21:14:05 2023
5,2,3,HCYPMGO (黑白郎君),[新聞] 孟加拉登革熱爆發已奪650命,Fri Sep  8 22:53:34 2023
24,3,21,king665714 (花生嬸魔術),[問卦] 不可能的任務哪一集最必看？,Sat Sep  9 00:12:39 2023
3,0,3,chubby31190 (優文專家),[問卦] 莫忘初衷這四個字是不是意義深遠？,Fri Sep  8 22:32:50 2023
0,0,0,kenbbc12321 (留痕),Re,Sat Sep  9 01:40:32 2023
10,0,10,vajra0001 (揮灑純粹),Re,Fri Sep  8 23:18:10 2023
14,7,7,a44320170 (紙箱叔叔),[問卦] 男女市場嚴重通膨太可怕了吧（有圖,Sat Sep  9 00:34:26 2023
1,0,1,romaziya (挑戰五子棋),Re,Fri Sep  8 23:56:08 2023
3,0,3,lianpig5566 (家庭教師殺手里包恩),Re,Fri Sep  8 21:36:46 2023
0,0,0,chen0625 (),[問卦] 薪資調幅超過基本薪資的多嗎？,Fri Sep  8 23:21:02 2023
4,3,1,koxinga (安西教練),[問卦] 臺北市發生地震嗎？,Sat Sep  9 08:05:11 2023
8,2,6,henin2003 (),[問卦] 如果可以讓一個人死而復活，你選誰？,Fri Sep  8 23:36:17 2023
2,3,-1,huabandd (我是阿肥巴你頭),Re,Fri Sep  8 23:36:14 2023
5,2,3,autokey (該起床啦),[問卦] 星期六感冒發燒在家如何休息才專業?,Sat Sep  9 08:04:07 2023
4,0,4,jason050117 (),[新聞] 頭城搶孤9/14深夜登場 法國選手挑戰爬孤棚「像被鬼追」,Fri Sep  8 22:55:33 2023
11,5,6,chunchie (阿奇),[問卦] 春夢才要打炮就醒了 有辦法回去嗎==,Sat Sep  9 05:23:30 2023
8,1,7,Himiko9975 (),[問卦] 大家都用哪一個購物平台???,Sat Sep  9 01:26:00 2023
3,3,0,Max0406 (LeGOATKingJames),[問卦] 美國男籃真丟臉 ,Fri Sep  8 22:40:47 2023
32,2,30,gu0117683 (觀落櫻),[問卦] 這隻是雨傘節ㄇ,Fri Sep  8 22:57:58 2023
9,1,8,momo520 (momo哭哭),[問卦] 女同事說他交過十二星座男友?,Sat Sep  9 00:10:52 2023
9,2,7,b1b2b3b4 (lemon),[新聞] 他家壁虎超敬業！深夜叼「古老生物」現身,Fri Sep  8 23:02:01 2023
5,2,3,EVEA (新試劑扶英戰士),[問卦] 台灣違建宅「會長大」 用功德灌溉出來嗎?,Fri Sep  8 21:13:36 2023
3,1,2,gn01982667 (冬瓜茶),[問卦] 買凶宅拆掉曝曬3年重建可以回本嗎？,Sat Sep  9 00:59:34 2023
2,0,2,askaleroux (Falcon),[問卦] 馬來西亞是肥宅國吧,Fri Sep  8 22:58:56 2023
10,4,6,littlejackbr (liljb),[問卦] 毛骨悚然撞鬼經驗哪篇最恐怖？,Fri Sep  8 23:22:02 2023
1,0,1,zapzone (問卦大師),[問卦] 詐騙 高利貸 這種,Fri Sep  8 22:57:32 2023
2,1,1,loadingN (sarsaparilla),[問卦] 去健工一個月會練太壯嗎?,Fri Sep  8 22:23:57 2023
5,3,2,usnavyseal (usmarine2008),[新聞] 迎來永和大違停時代？基層警點名1人狂擋單 交通組：已調整業,Fri Sep  8 21:35:13 2023
3,4,-1,joanzkow (星浪),[問卦] 微博熱搜第一：周杰倫演唱會受傷,Fri Sep  8 22:54:20 2023
7,0,7,emperor (派蘿派蘿得第一),[問卦] 聽呂捷聊歷史考試可以拿滿分嗎?,Sat Sep  9 00:33:11 2023
19,2,17,Beziehung (Beziehung),[新聞] 何博文慘了！遭踢爆論文抄襲　國民黨美,Fri Sep  8 22:35:30 2023
4,2,2,sasaki3630 (♥Gura鯊鯊的老公 ♥),[問卦] 工作年資，到底重不重要= =...???,Fri Sep  8 22:25:13 2023
24,3,21,s820912gmail (愛黨替代役覺青),[問卦] 當年台南維冠大樓倒塌有多震撼？,Fri Sep  8 21:27:10 2023
14,0,14,daisy100 (hey),[問卦] 對抗飛蚊症第n天,Sat Sep  9 00:36:08 2023
11,5,6,ubcs (覺★青年超冒險蓋),[新聞] 黑熊學院共同創辦人沈伯洋至立陶宛參加,Fri Sep  8 21:20:56 2023
0,0,0,goatcheese (goatcheese),[新聞] 超佛心！桃園賣菜嬤捐2救護車...總價,Sat Sep  9 08:53:33 2023
24,35,-11,MikaHakkinen (丟人現眼過氣老人),[新聞] 基本工資連續8年調升！蔡英文喊「達成目,Fri Sep  8 23:46:30 2023
4,0,4,wang111283 (王韋 豐),[問卦] 為何不檢討斜樓的營造廠？,Fri Sep  8 23:30:36 2023
9,0,9,badapuff (蜜瓜泡芙),[問卦] 躲去中國哪座深山隱居最有搞頭？,Sat Sep  9 08:02:40 2023
12,19,-7,james7923 (詹姆士Q),[新聞] 快訊／網紅士林遭酒駕男撞上！全身多處受,Sat Sep  9 08:38:39 2023
0,0,0,night0204 (小新),Re,Sat Sep  9 09:01:50 2023
15,6,9,jackymars5 ((                )),[問卦] 40歲交19歲女朋友可以嗎？,Sat Sep  9 06:14:03 2023
3,1,2,ivorysoap (ivorysoap),[新聞] 彰化溪湖鳳凰會館成了移工歡樂城 違建報,Fri Sep  8 21:05:43 2023
3,1,2,highyes (pat),[問卦] 大直崩塌現場附近有辣妹闆娘？,Fri Sep  8 22:21:33 2023
0,0,0,s327 (PrototypeDesigner),Re,Fri Sep  8 22:06:20 2023
7,0,7,lianpig5566 (家庭教師殺手里包恩),[問卦] 大阪腳踏車 和 台南的機車  哪個恐怖,Sat Sep  9 07:33:11 2023
9,1,8,YaoFun5566 (要飯56-家瑋),Re,Fri Sep  8 21:17:47 2023
6,0,6,chirex (不含銅鋰鋅),[問卦] 下雨屋頂漏水抓漏要怎辦？,Sat Sep  9 00:14:29 2023
6,0,6,micoun828 (平民),[問卦] 暴雨淹水時，孑孓在想什麼？,Fri Sep  8 23:44:45 2023
1,0,1,zcliu026 (KKK),[問卦] 去清復明的藥怎麼這麼貴？,Sat Sep  9 00:22:52 2023
5,0,5,ALEX492 (ALEX),[問卦] 樂事的海苔還是同個味道嗎？,Sat Sep  9 02:58:14 2023
3,0,3,bonfferoni (白莖汁腥),[問卦] 跟朋友一起比跟女友一起還快樂正常嗎？,Fri Sep  8 22:44:14 2023
24,10,14,aiio (小淡),[爆卦] World Gym 教練以代刷名義賣課程,Fri Sep  8 22:18:23 2023
4,1,3,bobo113020 (芷涵),[問卦] 害大直民宅坍塌建商到底有幾個,Sat Sep  9 00:51:42 2023
6,2,4,topic21000 (topic21000),[問卦] 如果基泰最終因為下陷受益會如何？,Sat Sep  9 08:03:08 2023
9,23,-14,renna038766 (微積分好難過),[問卦] 志祺分析許伯簡芝爭議！！,Fri Sep  8 23:19:45 2023
2,0,2,mongi (大體老屍),[問卦] 母豬的壽命長嗎？,Sat Sep  9 05:51:32 2023
1,0,1,songgood (ilovegoodgame),Re,Fri Sep  8 21:23:38 2023
2,1,1,mynewid (before sunshit),Re,Fri Sep  8 22:08:15 2023
7,2,5,samhou6 (好人™ ~SAM~),[問卦] 我授權全球使用我研發的常溫超導體技術,Sat Sep  9 05:58:03 2023
1,1,0,redDest (紅油),[問卦] 有代理孕母沒有代理孕父是不是歧視男性,Sat Sep  9 01:01:58 2023
4,1,3,nk11208z (小魯),[問卦] 剛看完曉涵哥講解國民黨在中國大陸時期的CC系太扯了,Fri Sep  8 23:30:55 2023
6,1,5,kyoiori100 (凱子),[問卦] 清明怎麼不是上墳圖,Fri Sep  8 21:09:41 2023
1,2,-1,Kimmy (Kimi),[問卦] nba薪資是個笑話嗎？,Fri Sep  8 22:40:28 2023
0,1,-1,donaldmusk (DonaldMusk),Re,Sat Sep  9 05:01:29 2023
0,0,0,assassinASHE (幹古專用帳號),Re,Sat Sep  9 06:08:48 2023
4,1,3,kiversonx17 (閉著眼睛買玉山金),[問卦] 鼎王的cp值不高吧!?,Fri Sep  8 21:52:03 2023
2,0,2,syensyens (syen),[問卦] 麥少東西回去拿會有愧疚感嗎？,Fri Sep  8 21:22:35 2023
2,4,-2,mikasamikoto (),[問卦] 為什麼不可以跟妹妹結婚,Sat Sep  9 08:44:49 2023
20,2,18,dosiris (希望大家開心),[問卦] 發現整個台北都是土壤液化高潛勢區？,Fri Sep  8 21:23:02 2023
2,0,2,GFDS (加油!!),Re,Fri Sep  8 23:38:56 2023
6,0,6,wettland5566 (溼地5566),[問卦] 白露之後484天氣轉涼很多了？,Sat Sep  9 01:06:00 2023
5,0,5,DCSHK (八卦版浪人47之28),Re,Fri Sep  8 22:32:52 2023
5,4,1,a74588123 (安安有品安安),[問卦] 大多數台灣人是不是閩南之恥？,Sat Sep  9 01:23:04 2023
0,0,0,incident (貴賓狗可愛:)),[問卦] 明天會放假嗎？,Sat Sep  9 02:56:05 2023
6,0,6,chanel1259 (kimkim),[問卦] 說到負全責會想到誰？,Sat Sep  9 00:43:30 2023
13,1,12,JHGF2468A (Joker),[問卦] 風雲的七言絕句後兩句是不是怪怪的,Fri Sep  8 22:34:21 2023
32,4,28,kkes0001 (unnamed3038),[問卦] 三總護理師>住院醫師喔？,Fri Sep  8 22:59:18 2023
12,3,9,radiohead56 (),[問卦] 本能寺之變後的織田家,Sat Sep  9 00:38:16 2023
6,4,2,bUnUd (妖尼姑!!妖尼姑!),[新聞] 60歲黃安軟掉了！怒公布超兇辣妹飯店房間,Fri Sep  8 23:06:08 2023
0,0,0,CuLiZn5566 (同理心5566),Re,Sat Sep  9 01:53:00 2023
4,1,3,DoncicInPTT (東七七),[問卦] 急！出差時老闆連傳7道Line訊息要我回公,Fri Sep  8 23:20:36 2023
3,0,3,ken52037g (Aihc),[問卦] 為什麼台版手遊都特別短命？,Fri Sep  8 21:27:53 2023
371,126,245,JinCheng5566 (金城五洗髮精),[新聞] 徐巧芯自豪「長得很漂亮」　苦苓：今年台,Fri Sep  8 21:42:01 2023
5,1,4,soy507 (soy507),[問卦] 怎麼會有車廠省料省的這麼誇張?,Sat Sep  9 08:06:50 2023
11,7,4,corydoras09 (),[問卦] 弄垮地基直接取得台北土地蓋房子？,Sat Sep  9 01:44:16 2023
47,4,43,dunkerrrrr (下巴),[問卦] 移工這個詞是不是可以更好？,Fri Sep  8 21:44:37 2023
15,0,15,qq326 (奈何還是要分離...),Re,Sat Sep  9 00:39:56 2023
8,3,5,zephyr105 (跳跳),[問卦] 這樣卡拉雞腿堡套餐OK嗎？,Sat Sep  9 08:35:17 2023
60,18,42,sandemo (一切都是剛剛開始),[新聞] 台海若發生戰爭 印度擬另闢戰場掣肘中國,Fri Sep  8 23:03:26 2023
2,3,-1,tpcfcabs (日出莫),[問卦] 改變人生的蚵仔煎,Sat Sep  9 07:56:55 2023
28,5,23,keel90135 (尼可),[新聞] 「我不跟黨主席喝咖啡」郭台銘霸氣一喊　,Fri Sep  8 22:22:57 2023
33,3,30,NewYorkLin (紐約林先生),[爆卦] 美國隊四強賽輸了,Fri Sep  8 22:34:18 2023
3,2,1,jganet (),[新聞] 補習班美語老師怕「斷糧」 竟當自耕農種出市值250萬元大麻,Sat Sep  9 07:50:55 2023
13,5,8,eddisontw (沙丘),[問卦] 廉航為什麼不裝電視 又沒多少成本?,Fri Sep  8 22:19:20 2023
9,5,4,spring719,[新聞] 太魯閣號搜出遺骨 台鐵:將1對1向家屬致,Sat Sep  9 03:14:05 2023
10,0,10,chaoswarudo (海上的人),[問卦] 台北現在有啥宵夜可以吃,Sat Sep  9 02:03:40 2023
49,1,48,MoreLight (大文),[問卦] 你喜歡孫燕姿的哪些歌？,Fri Sep  8 22:52:00 2023
27,6,21,Hazelburn (廉價酒),[問卦] 欸欸欸 這什麼蛙,Fri Sep  8 21:56:46 2023
0,0,0,rex8886 (re叉),Re,Sat Sep  9 03:37:15 2023
3,1,2,soulXdancer (lovedog),[問卦] 我的床怎麼在震動,Sat Sep  9 01:19:15 2023
0,0,0,a15568 (玉米),Re,Fri Sep  8 22:38:30 2023
5,1,4,chanel1259 (kimkim),[問卦] 雨這麼大你的車子現在停在哪裡,Sat Sep  9 02:05:43 2023
4,2,2,Fortran (Fortran),[問卦] 有沒有台北101強暴了的八卦,Sat Sep  9 01:08:30 2023
2,1,1,Pittsburgh (Pittsburgh),Re,Sat Sep  9 07:39:38 2023
6,0,6,"yang560831 (""壞人""喬尼)",Re,Sat Sep  9 01:33:54 2023
19,4,15,mikasamikoto (),[問卦]能打給習近平的話要跟他講什麼,Fri Sep  8 23:46:07 2023
0,0,0,R3hab (師爺),[問卦] 為什麼2016年後 囤房多了三倍？？,Sat Sep  9 08:53:47 2023
19,5,14,rechin0917 (YueZun),[問卦] 手榴彈投實彈是認真的嘛,Sat Sep  9 03:53:56 2023
2,1,1,med5566 (美德5566),[問卦] 國動臉書的留言都比主播有梗吧,Sat Sep  9 08:09:18 2023
1,4,-3,dragonmester (),[問卦] 沒包皮要怎麼尻,Sat Sep  9 08:45:50 2023
0,2,-2,Qorqios (丟臉比丟書還快==),[新聞] 美女隆乳上癮　38GG罩杯比頭還大　 坦言,Sat Sep  9 08:48:47 2023
6,3,3,input (),Re,Sat Sep  9 07:56:13 2023
7,0,7,lianpig5566 (家庭教師殺手里包恩),[問卦] 入境台灣真的有在嚴格查豬肉嗎,Fri Sep  8 22:26:34 2023
3,3,0,aabbcc520 (U質文),Re,Fri Sep  8 22:05:09 2023
6,0,6,ALEX492 (ALEX),[問卦] 哪裡吃的到那種中國吃播吃的東西？,Fri Sep  8 21:55:29 2023
1,1,0,ak904 (AK),[新聞] 足球／魔法教頭再發威！白劭宇補時進球　,Fri Sep  8 21:43:45 2023
5,2,3,CIIIO (郭+),[問卦] 都更不能一坪換一坪會怎樣？,Fri Sep  8 21:06:25 2023
3,4,-1,H23324216 (showtime),Re,Fri Sep  8 23:54:39 2023
1,0,1,j1973555 (ggez),[問卦] 抖音怎麼沒正妹挑戰跟肥宅做愛？？,Sat Sep  9 02:13:45 2023
2,0,2,tw30912 (tw30912),[問卦] 下週開始會有大跳槽潮嗎,Fri Sep  8 23:54:19 2023
4,1,3,howard24 (中信兄弟強攻強攻),[問卦] 笑死 美國怎麼輸德國啊,Fri Sep  8 22:34:59 2023
4,0,4,bombomtom (棒棒糖),Re,Fri Sep  8 23:06:32 2023
7,0,7,tyltyl95 (誰呀!),[問卦] 大直下陷公寓為什麼不會倒?,Fri Sep  8 23:19:40 2023
4,1,3,bencert (根本ㄏㄏ),[問卦] 公司內部系統很老舊的八卦？,Fri Sep  8 22:18:38 2023
3,0,3,andrewmiho (愛喝啤酒),[問卦] 第三名說第一名要努力的卦,Sat Sep  9 00:22:50 2023
8,0,8,iampig951753 (三重蔡涵瑤),Re,Sat Sep  9 06:39:48 2023
20,3,17,seibu (難過),[新聞] 男欠錢莊5萬慘遭打死丟包 主嫌抓到了,Fri Sep  8 22:39:17 2023
16,3,13,lelena (太陽神-RA),"[問卦] 小時候覺得買2房到底誰買,長大才知道殘酷",Fri Sep  8 21:55:01 2023
40,4,36,tiger911 (胖虎),[新聞] 高嘉瑜選情堪憂！吳欣岱搶深綠票　期待,Sat Sep  9 08:17:01 2023
9,3,6,xpradax (燈一明一滅地 雨倏忽而至),[問卦] 為何還有人敢買預售屋？,Sat Sep  9 00:27:10 2023
2,3,-1,er2 (LED topic),[問卦] 那個季節幹砲最爽,Fri Sep  8 20:56:43 2023
2,0,2,SeaForest (~海森林~),[問卦] 設計對白會不會有法律問題嗎？,Sat Sep  9 08:57:39 2023
1,0,1,ME13 (小鳥),[問卦] 節氣的白露的露要唸露還露？,Sat Sep  9 08:49:03 2023
7,13,-6,lukcat (LagCat),[新聞] 外界質疑進口蛋到岸價差5.7億 鄭文燦：35,Sat Sep  9 08:39:19 2023
1,0,1,chopinmozart (aha),Re,Fri Sep  8 21:16:32 2023
5,0,5,"yang560831 (""壞人""喬尼)",Re,Sat Sep  9 01:08:35 2023
6,1,5,LYS5566 (明燈❺❺❻❻),[問卦] 臺灣尋奇是不是找回流量密碼了?,Fri Sep  8 21:55:29 2023
71,19,52,EVEA (新試劑扶英戰士),[新聞] 有圖有真相！高嘉瑜爆基泰派黑衣人逼都更,Fri Sep  8 23:27:08 2023
9,8,1,Imotucc (建築師巴布),[問卦] 韓國診麼這麼貴==,Fri Sep  8 23:57:26 2023
2,0,2,ralfeistein (無名的ㄈㄓ王),[問卦] 這首新歌如何？Rick Astley的Never Gonna Stop,Sat Sep  9 00:27:45 2023
1,0,1,ga86041 (ga86041),[問卦] 泡麵吃的是一種情懷嗎,Fri Sep  8 23:24:36 2023
5,1,4,"god46 (大家好,我是JayJay林俊傑)",[問卦] 穿越到古代背唐詩三百首會怎樣？,Fri Sep  8 22:48:48 2023
3,2,1,soheadsome (師大狗鼻哥),[問卦] 朋友去大阪帶一堆日幣？,Sat Sep  9 07:12:32 2023
6,1,5,zhuilou ( ),[問卦] 新加坡不租房的話 購買力屌打台灣????,Fri Sep  8 22:47:42 2023
1,0,1,ihaveseven (中共說本週五要打來),Re,Fri Sep  8 21:30:57 2023
0,0,0,lwt501cx (爆裂魔法Explosion！！),[公告] 八卦板板規（2023.03.01）,Wed Mar  1 00:06:27 2023
0,0,0,aabbcc520 (U質文),[問卦] 在台灣如果32歲還是處男會怎樣嗎,Sat Sep  9 09:01:58 2023
1,0,1,DCHC (純愛基本教義派♥),Re,Sat Sep  9 02:15:23 2023
10,1,9,lute (澤弟大俠),[問卦] 現實中有沒有嫉惡如仇的名人?,Fri Sep  8 23:14:53 2023
3,1,2,paiopapa (),[新聞] 鬼月高雄離奇車禍 「碰」一聲車門凹洞...,Sat Sep  9 08:34:46 2023
20,2,18,TyuzuChou (子瑜我老婆),[新聞] 烏軍宣布學醫的女性必須登記服兵役 出國,Fri Sep  8 22:36:59 2023
39,23,16,morgen (摩根),[新聞] Mate60這新功能超重要!學者提1疑慮:華為,Fri Sep  8 22:51:33 2023
6,2,4,NUMB43 (晚了~該睡了),[問卦] 說真的館長的東西有多頂有多棒,Fri Sep  8 23:42:37 2023
8,2,6,nk11208z (小魯),[問卦] 慟!cyber punk2077發售到現在已經過了4年,Sat Sep  9 00:55:33 2023
2,1,1,ATTwo (咖哩給Gay),Re,Sat Sep  9 07:24:49 2023
3,0,3,smallplug (廢到笑),[問卦] 你各位還記得校歌怎麼唱嗎？,Fri Sep  8 23:52:29 2023
9,3,6,AMPHIBIA (amphibia),Re,Fri Sep  8 22:52:18 2023
20,1,19,Carmelo (Melo),[問卦] 師父點了Coffee 而我卻點了咖啡怎辦？,Sat Sep  9 00:09:05 2023
2,7,-5,Tiara5566 (霸凌天團),[新聞] 《原子少年2》真的要來了！　驚喜公布2男,Fri Sep  8 23:55:30 2023
6,0,6,hanoo960071 (枕頭山田哲人),[問卦] 為啥瑞德一直無法假釋成功？,Fri Sep  8 23:52:37 2023
8,2,6,jokerming847 (God of Mischief),[問卦] 台灣誰才是裝糊塗的高手？,Sat Sep  9 00:16:01 2023
11,3,8,JHENGKUNLIN (JHENGKUNLIN),[新聞] 土木技師直言 坍塌原可避免 建商省錢 ,Sat Sep  9 07:55:30 2023
6,0,6,wpd (??),[新聞] 中國賽 戴資穎激戰逾1小時打敗瑪琳 挺進4,Fri Sep  8 21:16:32 2023
6,0,6,orze04 (orz),Re,Fri Sep  8 23:40:49 2023
